WE ./path_to_the_west_texture 

NO ./path_to_the_north_texture         
SO ./path_to_the_south_texture         
EA ./asdasda

F 12,0,12
C 225,30,0

11111111
10000001
1000E001
10000001
11111111


